Year,Q1 Sales,Q2 Sales,Q3 Sales,Q4 Sales,Total Sales,Profit
2010,151,162,174,195,682,155
2011,192,213,227,244,876,213
2012,114,129,157,181,581,139
2013,171,182,198,210,761,159
2014,160,170,188,211,729,176
2015,120,141,157,183,601,95
2016,182,203,230,243,858,145
2017,186,212,225,252,875,135
2018,174,193,216,233,816,148
2019,174,199,226,239,838,158
2020,187,211,229,240,867,153
2021,199,223,234,249,905,210
2022,123,151,180,199,653,121
2023,102,123,147,160,532,94
2024,121,150,166,193,630,128